* Orientation=Landscape
=====     ==========
=====     \=========
====/      \\    F
===/        \\
==/    S     =======
=/           =======
====================
             =======
             =======
=====\       =======
======\     /=======
.
.
.
====================
====================
====================
====================



====================
====================
====================
====================
.
.
.
======\     \=======
=======\     \======
========\     \=====
=========\     \====
    \=====\
     \=====\
      \=====\
=\     \============
==\     \===========
===\     \==========
====\     \=========
.
.
.
====================
====================
               =====
               =====
==========     =====
==========     =====
==========     =====
==========
==========
====================
====================