==       =       \==
==\   S  =        \=
  \\    /=         \
 F \======\
====================
        \=/        
         =         /
\        =        /=
=\       =       /==
==\      =      /===
===\     =     /====
.
.
.
====     =     =====
====           =====
====\         //
    \==========
=    ==========    =
    /==========
===============\
====================
==/             \===
==               ===
==       =       ===